#...".......#
#.."........#
#.".........#
#"..........#
#############
