#......................................................................................#
#......................................................................................#
#######..........................................................................#######
#...".#..........................................................................#.."..#
#......................................................................................#
#############.".#######################################################..###############
#......................................................................................#
#............"""".................""..................."""""""""""""...""......."".....#
#...........""..""................""..................."................"".....""......#
#..........""....""...............""...................".................""..."".......#
#.........""......""..............""...................".................."".""........#
#........""........"".............""..................."...................""""........#
#.......""..........""............""...................""""""..............""".........#
#......""""""""""""""""...........""...................""""""............."".""........#
#.....""..............""..........""...................".................""..."".......#
#....""................"".........""..................."................"".....""......#
#...""..................""........""..................."...............""......."".....#
#..""...................."".......""...................".............."".........""....#
#.""......................""......"""""""""""""""".....""""""""""""".""...........""...#
########################################################################################
