#......................................................................................#
#......................................................................................#
#######..........................................................................#######
#...".#..........................................................................#.."..#
#......................................................................................#
#############.".################################..#####################..###############
#......................................................................................#
#............"..".............."".""...........""...""."""""""""""""...""......."".....#
#..........."""."".........."""...""..........""......."............."'."".....""......#
#..........""."..""..............."".........""...""...".........""......""..."".......#
#.........""..."..""........""".".""..""...."".."......"............""...."".""........#
#........""........""............."".......""..""......".........""......."""""........#
#.......""......"".."".........."""".""..."".......""..""""""."".......................#
#......""""""".."""""""......."".."".....""..."".""....""""""....""......."".""........#
#....."".......".....""...."".....""...."".."".""......".......""........""..."".......#
#...."".....""........."".....""..""..."".""..........."...""..........."".."".""......#
#...""....""............""..""...."".."".....""........"......"".......""......."".....#
#..""........""..........""...""..""..................."....."".......""...""....""....#
#.""............""........""....""""""""""""""""""....."""""""""""""."".."".......""...#
########################################################################################
